111111111111131111111
111001111111141111141
100011100000001111101
101111101111111111101
100040000000000001101
111111101111111111101
111000001100000000001
111011111110111111111
100000000000000000021
111111111111111111111
